20
20
0 1 0 1 0 0 1 0 0 0 0 0 1 0 1 1 0 1 0 9 
0 0 0 0 0 1 0 1 1 0 1 0 1 0 1 0 0 0 0 1 
0 0 0 0 1 1 0 1 0 1 1 1 0 0 0 0 0 0 0 0 
0 0 0 0 0 0 0 0 0 1 0 0 1 0 1 1 0 1 0 1 
0 0 0 1 1 0 1 0 0 0 0 1 0 1 1 1 0 0 0 1 
1 0 0 0 0 1 0 0 0 0 0 1 0 0 0 0 0 1 0 0 
0 0 0 0 1 0 0 0 0 0 1 1 0 1 0 0 1 0 0 0 
0 1 0 1 0 0 0 1 1 0 0 1 0 0 0 1 0 0 0 1 
1 0 1 0 0 1 0 0 0 0 0 0 0 0 1 0 0 0 0 0 
0 0 0 0 0 1 0 0 1 0 1 0 0 0 0 1 1 0 0 1 
0 0 0 1 0 0 1 0 1 0 1 1 0 1 0 1 1 0 0 0 
0 0 1 0 0 0 1 0 0 0 1 0 0 1 0 0 0 0 0 0 
0 1 1 1 0 1 0 0 0 1 1 0 0 0 0 0 0 0 0 1 
0 1 0 1 1 0 1 0 0 0 1 1 0 0 0 0 1 0 0 0 
1 0 0 0 0 0 0 0 0 0 0 1 1 0 0 0 0 1 0 0 
0 1 0 1 0 0 0 0 1 0 0 0 0 1 0 0 0 0 0 1 
0 0 0 0 0 0 1 0 1 0 1 0 0 0 0 0 0 0 0 0 
0 0 1 1 0 0 0 0 0 0 0 1 0 0 0 0 1 1 1 0 
0 0 0 0 0 1 0 0 1 0 1 0 1 0 0 0 0 1 0 0 
8 1 0 0 1 1 0 0 0 0 1 0 1 0 0 0 0 0 0 0 