20
20
1 0 0 0 1 0 0 0 0 1 0 0 0 0 0 0 0 1 0 9 
0 1 0 0 0 0 0 0 0 0 0 0 0 1 0 0 0 0 0 0 
0 0 1 0 0 0 0 0 1 0 0 0 0 0 0 1 0 0 0 1 
0 0 0 0 0 0 0 0 0 1 0 0 0 0 0 1 0 0 0 1 
0 1 0 0 1 1 1 0 0 1 0 0 0 0 0 0 0 1 0 0 
0 0 1 1 0 1 1 0 0 0 1 0 0 0 0 0 0 1 0 0 
0 0 1 0 0 0 0 0 0 0 0 0 0 1 0 0 1 0 0 0 
0 0 0 0 0 1 0 0 0 1 0 0 1 1 0 1 0 0 1 0 
1 1 0 0 0 1 0 0 1 0 0 0 0 0 1 0 1 0 0 0 
0 1 0 0 0 0 0 1 0 0 0 0 0 0 0 0 0 0 1 1 
0 0 0 0 0 0 0 0 1 0 0 1 0 0 0 0 0 0 0 1 
0 0 0 1 0 0 0 0 1 0 0 0 1 1 0 0 1 0 0 0 
0 0 0 1 0 1 0 0 1 0 1 0 0 0 1 0 0 0 0 0 
1 0 0 0 1 0 1 0 1 1 1 0 0 1 0 1 0 0 0 0 
0 0 1 0 1 0 0 0 0 1 0 0 1 0 1 0 0 1 0 0 
1 0 0 1 1 0 1 1 0 0 0 1 1 0 0 1 0 0 1 0 
0 0 1 0 0 1 1 0 0 1 0 0 1 0 0 1 1 0 0 0 
0 0 1 1 0 0 0 0 1 0 0 0 1 0 0 0 1 1 1 0 
1 0 1 1 0 1 0 0 1 0 0 0 0 1 1 1 1 1 1 1 
8 0 1 0 0 1 0 0 0 0 0 1 0 1 1 1 0 0 0 1 